111111111111111111111
10C0000C0100000010001
10M000001E1000M0100C1
100000CC0000000C10001
100C0000P0C0000100001
1000C000111C000001101
1000C000111C001M01101
1000C000111C001001101
111111111111111111111
