111111111111111111111111111111
100000000C000000000CC000000001
1000001111111000M0000001111111
100001111111000000000000011111
10000111101110000000000C000C11
10000001100C000000000000000011
100001111000000000000CC0000111
111000110000000P00000000000011
100000100000011111110001111101
110000000000000001111000000001
1111111111111000000C00000ME001
111000000011111110000001111111
111111CC0000000000000111000001
1111111111C0000000000000000001
100000000000000000000000000C01
111111111111111111111111111111
