111111111111111111111
100000000100000010001
10M000001E1000M010001
100000000000000010001
10000000P000000100001
100000001110000001101
100000001110001M01101
100000001110001001101
111111111111111111111
